        "        
 "" """ " """ "" 
 "" """ " """ "" 
                 
 "" " """"" " "" 
    "   "   "    
""" """ " """ """
""" "       " """
""" " "" "" " """
      "   "      
""" " """"" " """
""" "       " """
""" " """"" " """
        "        
 "" """ " """ "" 
  "           "  
" " " """"" " " "
    "   "   "    
 """"""   """""" 