        "        
 "" """ " """ "" 
 "" """ " """ "" 
                 
 "" " """"" " "" 
    "   "   "    
" " """ " """ " "
" " "       " " "
" " " "" "" " " "
" "   "   "   " "
" " " """"" " " "
" " "       " " "
" " " """"" " " "
        "        
 "" """ " """ "" 
  "           "  
" " " """"" " " "
"   "   "   "   "
"""""""   """""""